OOOOOOOOOOOOOOOOOOOOOOOUOOO
O   O . O O O O O O O O O O
O O O O O O . O   O O O O O
O O O O O O O O O O O   O O
O O O O O O O O O O O O . O
O O O O O . O O O O O O O O
O O O O O O O   O O O O O O
O O O O O O O O O O   O O O
O O O O O O O O O   O O O O
O O O O O O O O OOO O O O O
O O O O O O O O O . O O O O
O O O O O O O O O O O O O O
O O O O O O . O O O O O O O
OXO . O . O O O O O O O O U
OOOOOOOOOOOOOOOOOUOOOOOOOOO